|.....................................................|
|.....................................................|
|.....#......#.............................#..........|
|.....................................................|
|...................#........##.......................|
|.................................#...................|
|.........................##..........................|
|.........................................#...........|
|........##...........................................|
|.....................................................|
|.............................#..........#....##......|
|.....................................................|
|.....................................................|
|.....................................................|
|...........................................#.........|
|.....................................................|
|###.....................................#......#####.|
|#.............................#.....................#|
|........................................#...........#|
|........@C........................##...............#.|
|...................................................#.|
|.............................................########|
|###........................................##########|
|.....................................................|
|..................########...........................|

